18 18 18 18 18 18 18 18 18 18 18 18 18 18 18 18 18 18 18 18 18 18 18 18 18 18 18 18 18 18 18 18 18 18 18 18 18 18 18 18 18 18 18 18 18 18 18 18 18 18 18 18 18 18 18 18 18 18 18 18 18 18 18 18 18 18
18 18 18 18 18 18 18 18 18 18 18 18 18 18 18 18 18 18 18 18 18 18 18 18 18 18 18 18 18 18 18 18 18 18 18 18 18 18 18 18 18 18 18 18 18 18 18 18 18 18 18 18 18 18 18 18 18 18 18 18 18 18 18 18 18 18
18 18 18 18 18 18 18 18 18 18 18 18 18 18 18 18 18 18 18 18 18 18 18 18 18 18 18 18 18 18 18 18 18 18 18 18 18 18 18 18 18 18 18 18 18 18 18 18 18 18 18 18 18 18 18 18 18 18 18 18 18 18 18 18 18 18
18 18 18 18 18 18 18 18 18 18 18 18 18 18 18 18 18 18 18 18 18 18 18 18 18 18 18 18 18 18 18 18 18 18 18 18 18 18 18 18 18 18 18 18 18 18 18 18 18 18 18 18 18 18 18 18 18 18 18 18 18 18 18 18 18 18
18 18 18 18 18 18 18 18 18 18 18 18 18 18 18 18 18 18 18 18 18 18 18 18 18 18 18 18 18 18 18 18 18 18 18 18 18 18 18 18 18 18 18 18 18 18 18 18 18 18 18 18 18 18 18 18 18 18 18 18 18 18 18 18 18 18
18 18 18 18 18 18 18 18 18 18 18 18 18 18 18 18 18 18 18 18 18 18 18 18 18 18 18 18 18 18 18 18 18 18 18 18 18 18 18 18 18 18 18 18 18 18 18 18 18 18 18 18 18 18 18 18 18 18 18 18 18 18 18 18 18 18
18 18 18 18 18 18 18 18 18 18 18 18 18 18 18 18 18 18 18 18 18 18 18 18 18 18 18 18 18 18 18 18 18 18 18 18 18 18 18 18 18 18 18 18 18 18 18 18 18 18 18 18 18 18 18 18 18 18 18 18 18 18 18 18 18 18
18 18 18 18 18 18 18 18 18 18 18 18 18 18 18 18 18 18 18 18 18 18 18 18 18 18 18 18 18 18 18 18 18 18 18 18 18 18 18 18 18 18 18 18 18 18 18 18 18 18 18 18 18 18 18 18 18 18 18 18 18 18 18 18 18 18
18 18 18 18 18 18 18 18 0 1 1 1 1 6 9 9 9 9 9 0 1 1 1 1 1 1 1 1 1 1 1 1 1 1 1 1 1 1 1 1 1 1 1 1 5 5 5 5 5 5 5 5 5 5 5 5 5 6 18 18 18 18 18 18 18 18
18 18 18 18 18 18 18 18 7 9 9 9 9 7 9 9 9 9 9 7 9 9 9 9 9 9 9 9 9 9 9 9 9 9 9 9 9 9 9 7 9 9 9 9 9 9 9 9 9 9 9 9 9 9 9 9 9 7 18 18 18 18 18 18 18 18
18 18 18 18 18 18 18 18 7 9 9 9 9 7 9 9 7 9 9 7 9 9 9 9 9 9 9 9 9 9 9 9 9 9 9 9 9 9 9 7 9 9 9 11 11 11 11 11 9 9 9 9 9 9 9 9 9 7 18 18 18 18 18 18 18 18
18 18 18 18 18 18 18 18 7 9 11 9 9 7 9 9 7 9 9 7 9 9 9 9 9 9 9 9 9 11 9 9 9 9 9 9 9 9 9 7 9 9 9 9 9 9 9 9 9 9 9 9 9 9 9 11 9 7 18 18 18 18 18 18 18 18
18 18 18 18 18 18 18 18 7 9 9 9 9 7 9 9 7 9 9 7 9 9 1 1 1 6 9 9 9 11 11 9 9 9 9 7 9 9 9 7 16 16 16 16 16 16 16 16 16 16 16 16 7 9 9 11 9 7 18 18 18 18 18 18 18 18
18 18 18 18 18 18 18 18 7 9 9 9 9 7 9 9 9 9 9 7 9 9 9 9 9 7 9 9 11 11 9 11 9 9 9 7 9 11 9 7 9 9 9 9 7 9 9 9 9 9 9 9 7 9 9 11 9 7 18 18 18 18 18 18 18 18
18 18 18 18 18 18 18 18 7 9 9 9 9 7 9 9 9 9 9 7 9 9 9 9 9 7 9 9 11 9 11 11 9 9 9 7 9 9 9 7 9 9 9 9 7 9 9 9 9 9 11 9 7 9 9 11 9 7 18 18 18 18 18 18 18 18
18 18 18 18 18 18 18 18 7 9 9 16 16 16 16 16 9 9 16 16 16 16 16 16 16 17 9 9 11 11 11 9 9 9 9 7 9 9 9 7 9 9 9 9 7 9 9 9 9 9 9 9 7 9 9 9 9 7 18 18 18 18 18 18 18 18
18 18 18 18 18 18 18 18 7 9 9 10 9 9 9 10 9 9 10 9 9 9 7 9 9 9 9 9 9 9 9 9 9 9 9 16 16 16 16 16 9 9 9 9 7 9 9 9 7 9 9 9 7 9 9 9 9 7 18 18 18 18 18 18 18 18
18 18 18 18 18 18 18 18 7 9 9 10 9 9 9 9 9 9 9 9 9 9 7 9 9 9 9 9 9 9 9 9 9 9 9 9 9 9 9 9 9 9 9 9 9 9 9 9 7 9 9 9 7 9 9 9 9 7 18 18 18 18 18 18 18 18
18 18 18 18 18 18 18 18 7 9 9 10 9 9 9 9 9 9 9 9 9 9 7 9 9 9 9 9 16 16 16 16 7 9 9 9 9 9 9 9 11 11 11 11 9 9 9 9 7 9 9 9 7 9 9 9 9 7 18 18 18 18 18 18 18 18
18 18 18 18 18 18 18 18 7 9 9 16 16 16 16 16 16 16 16 9 9 9 7 9 9 7 9 9 9 9 9 9 7 9 9 9 9 9 9 9 9 9 9 9 9 9 9 9 7 9 9 9 7 9 9 9 9 7 18 18 18 18 18 18 18 18
18 18 18 18 18 18 18 18 7 9 9 9 9 7 9 9 9 9 7 9 9 9 7 9 9 7 9 9 9 9 9 9 16 16 16 9 9 9 16 16 16 16 16 16 16 16 16 16 16 16 16 16 16 9 9 9 9 7  18 18 18 18 18 18 18 18
18 18 18 18 18 18 18 18 7 9 9 9 9 7 9 9 9 9 7 9 9 9 7 9 9 7 9 9 9 9 9 9 9 9 9 9 9 9 9 9 9 9 9 9 9 9 9 9 9 9 9 9 9 9 9 9 9 7  18 18 18 18 18 18 18 18
18 18 18 18 18 18 18 18 7 9 9 9 9 7 9 9 9 9 7 9 9 9 7 9 9 7 9 9 11 11 11 11 9 9 9 9 9 9 9 9 9 9 9 9 9 9 9 9 9 9 9 11 9 9 9 9 9 7  18 18 18 18 18 18 18 18
18 18 18 18 18 18 18 18 7 9 11 9 9 9 9 9 9 9 9 9 9 9 9 9 9 9 9 9 11 11 11 11 9 9 9 9 9 9 9 9 9 9 11 11 9 9 9 9 9 9 9 11 11 11 9 9 9 7  18 18 18 18 18 18 18 18
18 18 18 18 18 18 18 18 7 9 11 9 9 9 9 9 9 9 9 9 9 9 9 9 9 9 9 9 9 9 9 9 9 9 9 9 9 9 9 9 9 9 9 9 9 9 9 9 9 9 9 9 11 11 9 9 9 7  18 18 18 18 18 18 18 18
18 18 18 18 18 18 18 18 7 9 11 9 9 9 9 9 11 11 9 9 9 9 16 16 16 16 16 16 16 16 16 16 16 16 16 16 16 16 16 16 16 16 16 16 16 16 16 16 7 9 9 9 9 9 9 9 9  18 18 18 18 18 18 18 18
18 18 18 18 18 18 18 18 7 9 11 9 9 10 9 9 11 11 9 9 9 9 9 9 9 10 9 9 9 9 9 9 9 10 9 9 9 9 9 10 9 9 9 9 9 9 9 9 7 9 9 9 9 9 9 9 9 7  18 18 18 18 18 18 18 18
18 18 18 18 18 18 18 18 7 9 11 9 9 7 9 9 9 9 9 9 9 9 9 9 9 10 9 9 9 9 9 9 9 10 9 9 11 9 9 10 9 9 9 9 9 9 9 9 7 9 9 9 9 9 9 9 9 7  18 18 18 18 18 18 18 18
18 18 18 18 18 18 18 18 7 9 11 9 9 16 16 16 16 16 16 16 16 16 9 9 9 10 9 9 9 9 9 9 9 9 9 9 11 9 9 7 9 9 9 10 9 9 9 9 9 9 9 9 16 16 16 9 9 7  18 18 18 18 18 18 18 18
18 18 18 18 18 18 18 18 7 9 9 9 9 9 9 9 9 7 9 9 9 9 9 9 9 10 9 9 9 9 9 9 9 9 9 9 9 9 9 7 9 9 9 10 9 9 9 9 9 9 9 9 7 9 9 9 9 7  18 18 18 18 18 18 18 18
18 18 18 18 18 18 18 18 7 9 9 9 9 9 9 9 9 7 9 9 9 9 9 9 9 10 9 9 9 9 16 16 16 16 16 16 16 16 16 16 16 16 16 16 16 9 9 9 9 9 9 9 7 9 9 9 9 7 18 18 18 18 18 18 18 18
18 18 18 18 18 18 18 18 7 9 9 9 9 9 9 9 9 7 9 9 9 9 9 9 9 10 9 9 9 9 9 9 9 9 9 9 9 7 9 9 9 9 9 9 9 9 9 9 7 9 9 9 7 9 9 9 9 7 18 18 18 18 18 18 18 18
18 18 18 18 18 18 18 18 7 16 16 16 16 16 16 16 16 16 9 9 9 7 9 9 9 10 9 9 11 9 9 9 9 9 9 9 9 7 9 9 9 9 9 9 9 9 9 9 7 9 9 9 7 9 9 9 9 7 18 18 18 18 18 18 18 18
18 18 18 18 18 18 18 18 7 9 9 9 9 9 10 9 9 9 9 9 9 7 9 9 9 10 9 9 9 9 9 9 9 9 9 9 9 7 9 9 9 9 9 9 9 9 9 9 7 9 9 9 7 9 9 9 9 7 18 18 18 18 18 18 18 18
18 18 18 18 18 18 18 18 7 9 9 9 9 9 10 9 9 9 9 9 9 7 9 9 9 16 16 16 16 16 16 10 9 9 9 9 9 7 1 1 1 1 1 1 1 1 1 1 17 9 9 9 16 16 16 16 16 7 18 18 18 18 18 18 18 18
18 18 18 18 18 18 18 187 9 9 11 9 9 10 9 9 9 11 9 9 7 9 9 9 9 9 9 9 9 9 10 9 9 11 9 9 7 9 9 9 9 9 9 9 9 9 9 9 9 9 9 9 9 9 9 9 7 18 18 18 18 18 18 18 18
18 18 18 18 18 18 18 18 7 9 11 9 11 9 10 9 9 9 9 9 9 7 9 9 9 9 9 9 11 9 9 10 9 9 9 9 9 7 9 9 11 9 9 9 9 9 9 9 9 9 9 9 9 9 9 9 9 7 18 18 18 18 18 18 18 18
18 18 18 18 18 18 18 187 9 9 11 9 9 10 9 9 9 9 9 9 7 9 9 9 9 9 9 9 9 9 10 9 9 9 9 9 7 9 9 9 9 9 9 9 9 9 9 9 9 9 9 9 9 9 9 9 7 18 18 18 18 18 18 18 18
18 18 18 18 18 18 18 18 7 9 9 9 9 9 16 16 16 16 16 16 16 7 9 9 9 9 9 9 9 9 9 10 9 9 9 9 9 9 9 9 9 9 9 0 16 16 16 16 16 16 16 16 16 16 9 9 9 7 18 18 18 18 18 18 18 18
18 18 18 18 18 18 18 18 7 9 9 9 9 9 9 9 9 9 9 9 9 9 9 9 9 16 16 16 16 16 16 10 9 9 9 9 9 9 9 9 9 9 9 10 9 9 9 9 9 9 9 9 9 9 9 9 9 7 18 18 18 18 18 18 18 18
18 18 18 18 18 18 18 18 7 9 9 9 9 9 9 9 9 9 9 9 9 9 9 9 9 7 9 9 9 9 9 9 9 9 9 9 9 9 9 9 9 9 9 10 9 9 11 9 9 9 9 9 9 9 9 9 9 7 18 18 18 18 18 18 18 18
18 18 18 18 18 18 18 18 7 16 16 16 9 9 9 9 9 9 9 11 11 11 9 9 9 7 9 9 9 9 9 9 9 9 9 9 9 9 9 9 9 9 9 10 9 9 9 9 9 9 9 9 9 9 9 9 9 7 18 18 18 18 18 18 18 18
18 18 18 18 18 18 18 18 7 9 9 9 9 9 9 7 9 9 9 11 11 11 9 9 9 7 9 9 9 9 9 9 9 11 11 9 9 7 9 9 9 9 9 10 9 9 9 9 7 9 9 9 9 11 9 9 9 7 18 18 18 18 18 18 18 18
18 18 18 18 18 18 18 18 7 9 9 9 9 9 9 7 9 9 9 9 9 9 9 9 9 7 9 9 9 7 9 9 9 11 11 9 9 7 9 9 9 16 16 17 9 9 9 9 7 9 9 9 9 9 9 9 9 7 18 18 18 18 18 18 18 18
18 18 18 18 18 18 18 18 7 9 9 9 9 9 9 7 9 9 9 9 9 9 9 9 9 7 9 9 9 7 9 9 9 11 11 9 9 7 9 9 9 9 9 9 9 9 9 9 7 9 9 11 9 9 9 9 9 7 18 18 18 18 18 18 18 18
18 18 18 18 18 18 18 18 7 9 9 11 9 9 9 16 16 16 16 16 16 16 16 16 16 7 9 9 9 7 9 9 9 9 11 9 9 7 9 9 9 9 9 9 9 9 9 9 7 9 9 11 9 9 12 9 9 7 18 18 18 18 18 18 18 18
18 18 18 18 18 18 18 18 7 9 9 9 9 9 9 9 9 9 9 10 9 9 9 9 9 9 9 9 9 7 9 9 9 9 9 9 9 7 16 16 16 16 16 16 16 16 16 16 7 9 9 11 9 9 7 9 9 7 18 18 18 18 18 18 18 18
18 18 18 18 18 18 18 18 7 9 9 9 9 9 9 9 9 9 9 10 9 9 9 9 9 9 9 9 9 7 9 9 9 9 9 9 9 7 9 9 9 9 9 9 9 9 9 9 7 9 9 11 9 9 7 9 9 7 18 18 18 18 18 18 18 18
18 18 18 18 18 18 18 18 7 9 9 9 7 9 9 9 9 9 9 10 9 9 9 11 9 9 9 9 9 9 9 9 9 9 9 9 9 7 9 9 9 9 9 9 9 9 9 9 7 9 9 9 9 9 7 9 9 7 18 18 18 18 18 18 18 18
18 18 18 18 18 18 18 18 7 9 9 9 7 9 9 11 11 9 9 10 9 9 9 9 9 9 9 9 9 9 9 9 9 9 9 9 9 7 9 9 16 16 16 16 9 9 9 9 7 9 9 9 9 9 7 9 9 7 18 18 18 18 18 18 18 18
18 18 18 18 18 18 18 18 7 9 9 9 7 9 9 11 11 9 9 10 9 9 9 9 9 9 9 9 9 16 16 16 16 16 16 16 16 7 9 9 9 9 9 9 9 9 9 9 9 9 9 9 9 9 7 9 9 7 18 18 18 18 18 18 18 18
18 18 18 18 18 18 18 18 7 9 9 9 7 9 9 9 9 9 9 10 16 16 16 16 16 16 16 9 9 7 9 9 9 9 9 9 9 7 9 9 9 9 9 9 11 11 11 9 9 9 9 9 9 9 7 9 9 7 18 18 18 18 18 18 18 18
18 18 18 18 18 18 18 18 7 9 9 9 7 9 9 9 9 9 9 9 9 9 9 9 9 9 9 9 9 7 9 9 9 9 9 9 9 7 9 9 9 9 9 9 9 9 9 9 9 9 9 9 9 9 8 9 9 7 18 18 18 18 18 18 18 18
18 18 18 18 18 18 18 18 7 9 9 9 16 16 16 16 16 9 9 9 9 9 9 9 9 9 9 9 9 7 9 9 9 7 9 9 9 7 9 9 9 9 9 9 9 4 1 1 1 1 1 3 9 9 9 9 9 7 18 18 18 18 18 18 18 18
18 18 18 18 18 18 18 18 7 9 9 9 9 9 9 9 9 9 9 9 9 9 9 9 9 11 11 9 9 7 9 9 9 7 9 9 9 7 9 9 11 9 9 9 9 9 9 9 9 9 9 9 9 9 9 9 9 7 18 18 18 18 18 18 18 18
18 18 18 18 18 18 18 18 7 9 9 9 9 9 9 9 9 9 9 9 9 9 7 9 9 9 9 9 9 7 9 9 9 10 9 9 9 9 9 9 9 9 9 9 9 9 9 9 9 9 9 9 9 9 11 9 9 7 18 18 18 18 18 18 18 18
18 18 18 18 18 18 18 18 7 9 9 9 9 9 9 9 9 9 9 9 9 9 7 9 9 9 9 9 9 7 9 9 9 10 9 9 9 9 9 9 9 9 9 9 9 9 9 9 9 9 9 9 9 9 9 9 9 7 18 18 18 18 18 18 18 18
18 18 18 18 18 18 18 18 15 16 16 16 16 16 16 16 16 16 16 16 16 16 16 16 16 16 16 16 16 16 16 16 16 16 16 16 16 16 16 16 16 16 16 16 16 16 16 9 9 9 16 16 16 16 16 16 16 17 18 18 18 18 18 18 18 18
18 18 18 18 18 18 18 18 18 18 18 18 18 18 18 18 18 18 18 18 18 18 18 18 18 18 18 18 18 18 18 18 18 18 18 18 18 18 18 18 18 18 18 18 18 18 18 18 18 18 18 18 18 18 18 18 18 18 18 18 18 18 18 18 18 18
18 18 18 18 18 18 18 18 18 18 18 18 18 18 18 18 18 18 18 18 18 18 18 18 18 18 18 18 18 18 18 18 18 18 18 18 18 18 18 18 18 18 18 18 18 18 18 18 18 18 18 18 18 18 18 18 18 18 18 18 18 18 18 18 18 18
18 18 18 18 18 18 18 18 18 18 18 18 18 18 18 18 18 18 18 18 18 18 18 18 18 18 18 18 18 18 18 18 18 18 18 18 18 18 18 18 18 18 18 18 18 18 18 18 18 18 18 18 18 18 18 18 18 18 18 18 18 18 18 18 18 18
18 18 18 18 18 18 18 18 18 18 18 18 18 18 18 18 18 18 18 18 18 18 18 18 18 18 18 18 18 18 18 18 18 18 18 18 18 18 18 18 18 18 18 18 18 18 18 18 18 18 18 18 18 18 18 18 18 18 18 18 18 18 18 18 18 18
18 18 18 18 18 18 18 18 18 18 18 18 18 18 18 18 18 18 18 18 18 18 18 18 18 18 18 18 18 18 18 18 18 18 18 18 18 18 18 18 18 18 18 18 18 18 18 18 18 18 18 18 18 18 18 18 18 18 18 18 18 18 18 18 18 18
18 18 18 18 18 18 18 18 18 18 18 18 18 18 18 18 18 18 18 18 18 18 18 18 18 18 18 18 18 18 18 18 18 18 18 18 18 18 18 18 18 18 18 18 18 18 18 18 18 18 18 18 18 18 18 18 18 18 18 18 18 18 18 18 18 18
18 18 18 18 18 18 18 18 18 18 18 18 18 18 18 18 18 18 18 18 18 18 18 18 18 18 18 18 18 18 18 18 18 18 18 18 18 18 18 18 18 18 18 18 18 18 18 18 18 18 18 18 18 18 18 18 18 18 18 18 18 18 18 18 18 18
18 18 18 18 18 18 18 18 18 18 18 18 18 18 18 18 18 18 18 18 18 18 18 18 18 18 18 18 18 18 18 18 18 18 18 18 18 18 18 18 18 18 18 18 18 18 18 18 18 18 18 18 18 18 18 18 18 18 18 18 18 18 18 18 18 18
18 18 18 18 18 18 18 18 18 18 18 18 18 18 18 18 18 18 18 18 18 18 18 18 18 18 18 18 18 18 18 18 18 18 18 18 18 18 18 18 18 18 18 18 18 18 18 18 18 18 18 18 18 18 18 18 18 18 18 18 18 18 18 18 18 18
