10 10 10 10 10 10 10 10 10 10 10 10 10 10 10 10 10 10 10 10 10 10 10 10 10 10 10 10 10 10 10 10 10 10 10 10 10 10 10 10 10 10 10 10 10 10 10 10 10 10 10 10 10 10 10 10 10 10 10 10 10 10 10 10 10 10 10 10 10 10 10 10 10 10 10 10 10 10 10 10 10 10 10 10 10 10 10 10 10 10 10 10 10 10 10 10 10 10 10 10
10 10 10 10 10 10 10 10 10 10 10 10 10 10 10 10 10 10 10 10 10 10 10 10 10 10 10 10 10 10 10 10 10 10 10 10 10 10 10 10 10 10 10 10 10 10 10 10 10 10 10 10 10 10 10 10 10 10 10 10 10 10 10 10 10 10 10 10 10 10 10 10 10 10 10 10 10 10 10 10 10 10 10 10 10 10 10 10 10 10 10 10 10 10 10 10 10 10 10 10
10 10 10 10 10 10 10 10 10 10 10 10 10 10 10 10 10 10 10 10 10 10 10 10 10 10 10 10 10 10 10 10 10 10 10 10 10 10 10 10 10 10 10 10 10 10 10 10 10 10 10 10 10 10 10 10 10 10 10 10 10 10 10 10 10 10 10 10 10 10 10 10 10 10 10 10 10 10 10 10 10 10 10 10 10 10 10 10 10 10 10 10 10 10 10 10 10 10 10 10 
10 10 10 10 10 10 10 10 10 10 10 10 10 10 10 10 10 10 10 10 10 10 10 10 10 10 10 10 10 10 10 10 10 10 10 10 10 10 10 10 10 10 10 10 10 10 10 10 10 10 10 10 10 10 10 10 10 10 10 10 10 10 10 10 10 10 10 10 10 10 10 10 10 10 10 10 10 10 10 10 10 10 10 10 10 10 10 10 10 10 10 10 10 10 10 10 10 10 10 10 
10 10 10 10 10 10 10 10 10 10 10 10 10 10 10 10 10 10 10 10 10 10 10 10 10 10 10 10 10 10 10 10 10 10 10 10 10 10 10 10 10 10 10 10 10 10 10 10 10 10 10 10 10 10 10 10 10 10 10 10 10 10 10 10 10 10 10 10 10 10 10 10 10 10 10 10 10 10 10 10 10 10 10 10 10 10 10 10 10 10 10 10 10 10 10 10 10 10 10 10 
10 10 10 10 10 10 10 10 10 10 10 10 10 10 10 10 10 10 10 10 10 10 10 10 10 10 10 10 10 10 10 10 10 10 10 10 10 10 10 10 10 10 10 10 10 10 10 10 10 10 10 10 10 10 10 10 10 10 10 10 10 10 10 10 10 10 10 10 10 10 10 10 10 10 10 10 10 10 10 10 10 10 10 10 10 10 10 10 10 10 10 10 10 10 10 10 10 10 10 10 
10 10 10 10 10 10 10 10 10 10 10 10 10 10 10 10 10 10 10 10 10 10 10 10 10 10 10 10 10 10 10 10 10 10 10 10 10 10 10 10 10 10 10 10 10 10 10 10 10 10 10 10 10 10 10 10 10 10 10 10 10 10 10 10 10 10 10 10 10 10 10 10 10 10 10 10 10 10 10 10 10 10 10 10 10 10 10 10 10 10 10 10 10 10 10 10 10 10 10 10 
10 10 10 10 10 10 10 10 10 10 10 10 10 10 10 10 10 10 10 10 10 10 10 10 10 10 10 10 10 10 10 10 10 10 10 10 10 10 10 10 10 10 10 10 10 10 10 10 10 10 10 10 10 10 10 10 10 10 10 10 10 10 10 10 10 10 10 10 10 10 10 10 10 10 10 10 10 10 10 10 10 10 10 10 10 10 10 10 10 10 10 10 10 10 10 10 10 10 10 10 
10 10 10 10 10 10 10 10 10 10 10 10 10 10 10 10 10 10 10 10 10 10 10 10 10 10 10 10 10 10 10 10 10 10 10 10 10 10 10 10 10 10 10 10 10 10 10 10 10 10 10 10 10 10 10 10 10 10 10 10 10 10 10 10 10 10 10 10 10 10 10 10 10 10 10 10 10 10 10 10 10 10 10 10 10 10 10 10 10 10 10 10 10 10 10 10 10 10 10 10 
10 10 10 10 10 10 10 10 10 10 10 10 10 10 10 10 10 10 10 10 10 10 10 10 10 10 10 10 10 10 10 10 10 10 10 10 10 10 10 10 10 10 10 10 10 10 10 10 10 10 10 10 10 10 10 10 10 10 10 10 10 10 10 10 10 10 10 10 10 10 10 10 10 10 10 10 10 10 10 10 10 10 10 10 10 10 10 10 10 10 10 10 10 10 10 10 10 10 10 10 
10 10 10 10 10 10 10 10 10 10 10 10 10 10 10 10 10 10 10 10 10 10 10 10 10 10 10 10 10 10 10 10 10 10 10 10 10 10 10 10 10 10 10 10 10 10 10 10 10 10 10 10 10 10 10 10 10 10 10 10 10 10 10 10 10 10 10 10 10 10 10 10 10 10 10 10 10 10 10 10 10 10 10 10 10 10 10 10 10 10 10 10 10 10 10 10 10 10 10 10 
10 10 10 10 10 10 10 10 10 10 10 10 10 10 10 10 10 10 10 10 10 10 10 10 10 10 10 10 10 10 10 10 10 10 10 10 10 10 10 10 10 10 10 10 10 10 10 10 10 10 10 10 10 10 10 10 10 10 10 10 10 10 10 10 10 10 10 10 10 10 10 10 10 10 10 10 10 10 10 10 10 10 10 10 10 10 10 10 10 10 10 10 10 10 10 10 10 10 10 10 
10 10 10 10 10 10 10 10 10 10 10 10 10 10 10 10 10 10 10 10 10 10 10 10 10 10 10 10 10 10 10 10 10 10 10 10 10 10 10 10 10 10 10 10 10 10 10 10 10 10 10 10 10 10 10 10 10 10 10 10 10 10 10 10 10 10 10 10 10 10 10 10 10 10 10 10 10 10 10 10 10 10 10 10 10 10 10 10 10 10 10 10 10 10 10 10 10 10 10 10 
10 10 10 10 10 10 10 10 10 10 10 10 10 10 10 10 10 10 10 10 10 10 10 10 10 10 10 10 10 10 10 10 10 10 10 10 10 10 10 10 10 10 10 10 10 10 10 10 10 10 10 10 10 10 10 10 10 10 10 10 10 10 10 10 10 10 10 10 10 10 10 10 10 10 10 10 10 10 10 10 10 10 10 10 10 10 10 10 10 10 10 10 10 10 10 10 10 10 10 10 
10 10 10 10 10 10 10 10 10 10 10 10 10 10 10 10 10 10 10 10 10 10 10 10 10 10 10 10 10 10 10 10 10 10 10 10 10 10 10 10 10 10 10 10 10 10 10 10 10 10 10 10 10 10 10 10 10 10 10 10 10 10 10 10 10 10 10 10 10 10 10 10 10 10 10 10 10 10 10 10 10 10 10 10 10 10 10 10 10 10 10 10 10 10 10 10 10 10 10 10 
10 10 10 10 10 10 10 10 10 10 10 10 10 10 10 10 10 10 10 10 10 10 10 10 10 10 10 10 10 10 10 10 10 10 10 10 10 10 10 10 10 10 10 10 10 10 10 10 10 10 10 10 10 10 10 10 10 10 10 10 10 10 10 10 10 10 10 10 10 10 10 10 10 10 10 10 10 10 10 10 10 10 10 10 10 10 10 10 10 10 10 10 10 10 10 10 10 10 10 10 
10 10 10 10 10 10 10 10 10 10 10 10 10 10 10 10 10 10 10 10 10 10 10 10 10 10 10 10 10 10 10 10 10 10 10 10 10 10 10 10 10 10 10 10 10 10 10 10 10 10 10 10 10 10 10 10 10 10 10 10 10 10 10 10 10 10 10 10 10 10 10 10 10 10 10 10 10 10 10 10 10 10 10 10 10 10 10 10 10 10 10 10 10 10 10 10 10 10 10 10 
10 10 10 10 10 10 10 10 10 10 10 10 10 10 10 10 10 10 10 10 10 10 10 10 10 10 10 10 10 10 10 10 10 10 10 10 10 10 10 10 10 10 10 10 10 10 10 10 10 10 10 10 10 10 10 10 10 10 10 10 10 10 10 10 10 10 10 10 10 10 10 10 10 10 10 10 10 10 10 10 10 10 10 10 10 10 10 10 10 10 10 10 10 10 10 10 10 10 10 10 
10 10 10 10 10 10 10 10 10 10 10 10 10 10 10 10 10 10 10 10 10 10 10 10 10 10 10 10 10 10 10 10 10 10 10 10 10 10 10 10 10 10 10 10 10 10 10 10 10 10 10 10 10 10 10 10 10 10 10 10 10 10 10 10 10 10 10 10 10 10 10 10 10 10 10 10 10 10 10 10 10 10 10 10 10 10 10 10 10 10 10 10 10 10 10 10 10 10 10 10 
10 10 10 10 10 10 10 10 10 10 10 10 10 10 10 10 10 10 10 10 10 10 10 10 10 10 10 10 10 10 10 10 10 10 10 10 10 10 10 10 10 10 10 10 10 10 10 10 10 10 10 10 10 10 10 10 10 10 10 10 10 10 10 10 10 10 10 10 10 10 10 10 10 10 10 10 10 10 10 10 10 10 10 10 10 10 10 10 10 10 10 10 10 10 10 10 10 10 10 10 
10 10 10 10 10 10 10 10 10 10 10 10 10 10 10 10 10 10 10 10 0 1 1 1 1 1 1 1 1 1 1 1 1 1 1 1 1 1 1 1 1 1 1 1 1 1 1 1 1 1 1 1 1 1 1 1 1 1 1 1 1 1 1 1 1 1 1 1 1 1 1 1 1 1 1 1 1 1 1 1 16 10 10 10 10 10 10 10 10 10 10 10 10 10 10 10 10 10 10 10 
10 10 10 10 10 10 10 10 10 10 10 10 10 10 10 10 10 10 10 10 15 18 18 18 18 18 18 18 2 18 18 18 18 2 18 18 18 18 18 18 18 18 18 18 18 18 18 18 18 18 18 15 18 18 18 18 18 18 18 18 18 15 18 18 18 18 18 18 18 18 18 18 18 15 18 18 18 18 18 18 15 10 10 10 10 10 10 10 10 10 10 10 10 10 10 10 10 10 10 10 
10 10 10 10 10 10 10 10 10 10 10 10 10 10 10 10 10 10 10 10 15 18 18 18 18 18 18 18 2 18 18 18 18 2 18 18 18 18 18 18 18 18 18 18 18 18 18 18 18 18 18 15 18 18 18 18 18 18 18 18 18 15 18 18 18 18 18 18 18 18 18 18 18 15 18 18 18 18 18 18 15 10 10 10 10 10 10 10 10 10 10 10 10 10 10 10 10 10 10 10 
10 10 10 10 10 10 10 10 10 10 10 10 10 10 10 10 10 10 10 10 15 18 18 18 18 18 18 18 2 18 18 18 18 2 18 18 18 18 18 18 18 18 3 3 18 18 18 18 18 18 18 15 18 18 18 18 18 18 18 18 18 15 18 18 18 18 18 18 18 18 18 18 18 15 18 18 18 18 18 18 15 10 10 10 10 10 10 10 10 10 10 10 10 10 10 10 10 10 10 10
10 10 10 10 10 10 10 10 10 10 10 10 10 10 10 10 10 10 10 10 15 18 18 18 18 18 18 18 2 18 18 18 18 2 18 18 18 18 18 2 18 18 3 3 18 18 18 8 8 8 8 8 8 8 8 18 18 18 18 18 18 8 8 8 18 18 8 8 15 18 18 18 18 15 18 18 18 18 18 18 15 10 10 10 10 10 10 10 10 10 10 10 10 10 10 10 10 10 10 10 
10 10 10 10 10 10 10 10 10 10 10 10 10 10 10 10 10 10 10 10 15 8 8 8 3 18 8 3 2 18 18 18 18 2 8 8 8 8 8 2 18 18 18 18 18 18 18 18 18 18 18 18 18 18 18 18 18 18 18 18 18 18 18 18 18 18 18 18 15 18 18 18 18 8 8 8 8 18 18 18 15 10 10 10 10 10 10 10 10 10 10 10 10 10 10 10 10 10 10 10
10 10 10 10 10 10 10 10 10 10 10 10 10 10 10 10 10 10 10 10 15 18 18 18 18 18 18 18 18 18 18 18 18 18 18 18 18 18 18 2 18 18 18 18 18 18 18 18 18 18 18 18 18 18 3 3 3 18 18 18 18 18 18 18 18 18 18 18 15 18 18 18 18 18 18 18 18 18 18 18 15 10 10 10 10 10 10 10 10 10 10 10 10 10 10 10 10 10 10 10 
10 10 10 10 10 10 10 10 10 10 10 10 10 10 10 10 10 10 10 10 15 18 18 18 18 18 18 18 18 18 18 2 18 18 18 18 18 18 18 2 8 8 8 8 8 18 18 18 18 18 18 18 18 18 18 18 18 18 18 18 18 18 18 18 18 18 18 18 15 18 18 18 18 18 18 18 18 18 18 18 15 10 10 10 10 10 10 10 10 10 10 10 10 10 10 10 10 10 10 10 
10 10 10 10 10 10 10 10 10 10 10 10 10 10 10 10 10 10 10 10 15 18 18 18 2 18 18 3 3 18 18 2 18 18 18 18 18 18 18 2 18 18 18 18 18 18 18 18 18 18 18 18 18 18 18 18 18 18 18 18 18 18 18 18 18 18 18 18 15 18 18 18 18 18 18 18 18 18 18 18 15 10 10 10 10 10 10 10 10 10 10 10 10 10 10 10 10 10 10 10 
10 10 10 10 10 10 10 10 10 10 10 10 10 10 10 10 10 10 10 10 15 18 18 18 2 18 18 3 3 18 18 2 18 18 18 18 3 18 18 2 18 18 18 18 18 18 18 18 18 18 18 18 18 18 18 18 8 8 8 8 8 8 8 8 8 8 8 8 8 8 8 8 18 18 18 8 8 8 8 8 15 10 10 10 10 10 10 10 10 10 10 10 10 10 10 10 10 10 10 10 
10 10 10 10 10 10 10 10 10 10 10 10 10 10 10 10 10 10 10 10 15 18 18 18 2 18 18 18 18 18 18 2 18 18 18 18 3 18 18 2 18 18 18 18 18 18 2 18 18 18 18 18 18 18 18 18 18 18 18 18 18 3 3 18 18 18 18 18 18 18 18 18 18 18 18 18 18 18 18 18 15 10 10 10 10 10 10 10 10 10 10 10 10 10 10 10 10 10 10 10 
10 10 10 10 10 10 10 10 10 10 10 10 10 10 10 10 10 10 10 10 15 18 18 18 2 18 18 18 18 18 18 18 18 18 18 18 3 18 18 18 18 18 18 18 18 18 2 18 18 18 3 3 3 18 18 18 18 18 18 18 18 3 3 18 18 18 18 18 18 18 18 18 18 18 18 18 18 18 18 18 15 10 10 10 10 10 10 10 10 10 10 10 10 10 10 10 10 10 10 10 
10 10 10 10 10 10 10 10 10 10 10 10 10 10 10 10 10 10 10 10 15 18 18 18 15 18 18 18 18 18 18 18 18 18 18 18 3 18 18 18 18 18 18 18 18 18 2 18 18 18 3 3 3 18 18 18 18 18 18 18 18 3 3 3 3 3 3 3 3 3 3 3 3 3 3 3 18 18 18 18 15 10 10 10 10 10 10 10 10 10 10 10 10 10 10 10 10 10 10 10 
10 10 10 10 10 10 10 10 10 10 10 10 10 10 10 10 10 10 10 10 15 18 18 18 8 8 8 8 8 8 8 8 8 8 18 18 18 18 18 18 18 18 18 18 18 18 2 18 18 18 18 18 18 18 18 18 18 18 18 18 18 18 18 18 18 18 18 18 18 18 18 18 18 18 18 18 18 18 18 18 15 10 10 10 10 10 10 10 10 10 10 10 10 10 10 10 10 10 10 10 
10 10 10 10 10 10 10 10 10 10 10 10 10 10 10 10 10 10 10 10 15 18 18 18 18 18 18 18 18 18 18 18 18 18 18 18 18 18 18 18 18 3 3 3 18 18 2 18 18 18 18 18 18 18 18 18 18 18 18 18 18 18 18 18 18 18 18 18 18 18 18 18 18 18 18 18 18 18 18 18 15 10 10 10 10 10 10 10 10 10 10 10 10 10 10 10 10 10 10 10 
10 10 10 10 10 10 10 10 10 10 10 10 10 10 10 10 10 10 10 10 15 18 18 18 3 3 18 18 18 18 18 18 18 18 18 18 18 18 18 18 18 3 3 3 18 18 2 18 18 18 18 18 18 8 8 8 8 8 8 8 8 8 18 18 18 8 8 15 18 18 18 18 18 3 3 3 3 18 18 18 15 10 10 10 10 10 10 10 10 10 10 10 10 10 10 10 10 10 10 10 
10 10 10 10 10 10 10 10 10 10 10 10 10 10 10 10 10 10 10 10 15 18 18 18 18 3 3 18 18 18 18 3 3 3 3 18 18 18 18 18 18 18 18 18 18 18 2 18 18 18 18 18 18 15 18 18 18 3 18 18 18 18 18 18 18 18 18 15 18 18 18 18 18 3 3 3 3 18 18 18 15 10 10 10 10 10 10 10 10 10 10 10 10 10 10 10 10 10 10 10 
10 10 10 10 10 10 10 10 10 10 10 10 10 10 10 10 10 10 10 10 15 18 18 18 18 18 18 18 18 18 18 18 18 18 18 18 18 18 18 18 18 18 18 18 18 18 2 8 8 8 18 18 18 15 18 18 18 3 18 18 18 18 18 18 18 18 18 15 18 18 18 18 18 3 3 3 3 18 18 18 15 10 10 10 10 10 10 10 10 10 10 10 10 10 10 10 10 10 10 10 
10 10 10 10 10 10 10 10 10 10 10 10 10 10 10 10 10 10 10 10 15 8 8 8 8 8 8 8 8 8 18 18 18 18 18 18 18 18 18 18 18 18 18 18 18 18 2 18 18 18 18 18 18 15 18 18 18 3 18 18 18 3 18 18 3 3 3 15 18 18 18 18 18 3 3 3 3 18 18 18 15 10 10 10 10 10 10 10 10 10 10 10 10 10 10 10 10 10 10 10 
10 10 10 10 10 10 10 10 10 10 10 10 10 10 10 10 10 10 10 10 15 18 18 18 18 18 18 15 18 18 18 18 18 18 18 18 8 8 8 8 8 8 8 8 8 8 8 18 18 18 18 18 18 15 18 18 18 3 18 18 18 3 18 18 18 18 3 15 18 18 18 18 18 18 18 18 18 18 18 18 15 10 10 10 10 10 10 10 10 10 10 10 10 10 10 10 10 10 10 10 
10 10 10 10 10 10 10 10 10 10 10 10 10 10 10 10 10 10 10 10 15 18 18 18 18 18 18 15 18 18 18 18 18 18 18 18 15 18 18 18 18 15 18 18 18 18 18 18 18 18 18 18 18 15 18 18 18 18 18 18 18 3 18 18 18 18 18 15 18 18 18 18 18 18 18 18 18 18 18 18 15 10 10 10 10 10 10 10 10 10 10 10 10 10 10 10 10 10 10 10 
10 10 10 10 10 10 10 10 10 10 10 10 10 10 10 10 10 10 10 10 15 18 18 3 3 18 18 15 18 18 18 3 3 18 18 18 15 18 18 18 18 15 18 18 18 18 18 18 18 18 18 18 18 15 18 18 18 18 18 18 18 3 18 18 18 18 18 15 18 18 18 18 18 18 18 18 2 18 18 18 15 10 10 10 10 10 10 10 10 10 10 10 10 10 10 10 10 10 10 10 
10 10 10 10 10 10 10 10 10 10 10 10 10 10 10 10 10 10 10 10 15 18 18 3 3 18 18 15 18 18 18 3 3 18 18 18 15 18 18 18 18 15 18 18 18 3 3 3 18 18 18 18 18 18 18 18 18 3 8 8 8 8 8 8 8 8 8 8 8 8 8 8 8 18 18 18 2 18 18 18 15 10 10 10 10 10 10 10 10 10 10 10 10 10 10 10 10 10 10 10 
10 10 10 10 10 10 10 10 10 10 10 10 10 10 10 10 10 10 10 10 15 18 18 18 18 18 18 18 18 18 18 18 18 18 18 18 18 18 18 18 18 15 18 18 18 18 18 18 18 18 18 18 18 18 18 18 18 3 18 18 18 18 18 18 18 18 18 18 18 18 18 18 18 18 18 18 2 18 18 18 15 10 10 10 10 10 10 10 10 10 10 10 10 10 10 10 10 10 10 10 
10 10 10 10 10 10 10 10 10 10 10 10 10 10 10 10 10 10 10 10 15 18 18 18 18 18 18 18 18 18 18 18 18 18 18 18 18 18 18 18 18 15 18 18 18 18 18 18 18 18 18 18 18 18 18 18 18 3 18 18 18 18 18 18 18 18 18 18 18 18 18 18 18 18 18 18 18 18 18 18 15 10 10 10 10 10 10 10 10 10 10 10 10 10 10 10 10 10 10 10 
10 10 10 10 10 10 10 10 10 10 10 10 10 10 10 10 10 10 10 10 15 18 18 18 18 15 18 18 18 18 15 18 18 18 8 8 8 8 8 8 8 8 8 8 8 8 8 8 2 18 18 18 18 18 18 18 18 3 18 18 18 2 18 18 18 18 18 18 18 18 18 18 18 18 18 18 18 18 18 18 15 10 10 10 10 10 10 10 10 10 10 10 10 10 10 10 10 10 10 10 
10 10 10 10 10 10 10 10 10 10 10 10 10 10 10 10 10 10 10 10 15 18 18 18 18 15 18 18 18 18 15 18 18 18 2 18 18 18 18 18 18 18 18 18 18 18 18 18 2 18 18 18 18 18 18 18 18 3 18 18 18 2 18 18 18 18 8 8 8 8 8 8 8 8 8 8 8 8 8 8 15 10 10 10 10 10 10 10 10 10 10 10 10 10 10 10 10 10 10 10 
10 10 10 10 10 10 10 10 10 10 10 10 10 10 10 10 10 10 10 10 15 18 18 18 18 15 18 18 8 8 15 18 18 18 2 18 18 18 18 18 18 18 18 3 18 3 18 18 2 18 18 18 3 3 3 3 3 3 3 3 3 3 18 18 18 18 15 18 18 18 15 18 18 18 18 18 18 18 3 18 15 10 10 10 10 10 10 10 10 10 10 10 10 10 10 10 10 10 10 10 
10 10 10 10 10 10 10 10 10 10 10 10 10 10 10 10 10 10 10 10 15 18 18 18 18 15 18 18 18 18 15 18 18 18 18 18 18 18 18 18 18 18 18 18 18 18 18 18 2 18 18 18 3 18 18 18 18 18 18 18 18 18 18 18 18 18 15 18 18 18 15 18 18 18 18 18 18 18 18 18 15 10 10 10 10 10 10 10 10 10 10 10 10 10 10 10 10 10 10 10 
10 10 10 10 10 10 10 10 10 10 10 10 10 10 10 10 10 10 10 10 15 18 18 18 18 15 18 18 18 18 15 18 18 18 18 18 18 18 8 8 8 8 8 2 18 18 18 18 2 18 18 18 3 18 18 18 18 18 18 18 18 18 18 18 18 18 15 18 18 18 18 18 18 15 18 18 8 8 8 8 15 10 10 10 10 10 10 10 10 10 10 10 10 10 10 10 10 10 10 10 
10 10 10 10 10 10 10 10 10 10 10 10 10 10 10 10 10 10 10 10 15 18 18 18 18 15 18 18 18 18 15 18 18 18 3 18 18 18 18 18 18 18 18 2 18 18 18 18 2 18 18 18 3 18 18 18 18 18 18 18 18 18 18 18 18 18 15 18 3 18 18 18 18 15 18 18 18 18 18 18 15 10 10 10 10 10 10 10 10 10 10 10 10 10 10 10 10 10 10 10 
10 10 10 10 10 10 10 10 10 10 10 10 10 10 10 10 10 10 10 10 15 18 18 18 18 15 8 8 18 18 15 18 18 18 18 18 18 18 18 3 3 18 18 2 18 18 3 18 18 18 18 18 3 18 18 18 18 18 18 18 18 18 18 18 18 18 15 18 18 18 18 18 18 15 18 18 18 18 18 18 15 10 10 10 10 10 10 10 10 10 10 10 10 10 10 10 10 10 10 10 
10 10 10 10 10 10 10 10 10 10 10 10 10 10 10 10 10 10 10 10 15 18 18 18 18 15 18 18 18 18 15 18 18 18 2 18 18 18 18 18 18 18 18 2 18 18 3 18 18 18 18 18 3 18 18 18 18 8 8 8 8 8 8 8 8 8 8 8 8 8 8 8 8 8 8 8 18 18 18 18 15 10 10 10 10 10 10 10 10 10 10 10 10 10 10 10 10 10 10 10 
10 10 10 10 10 10 10 10 10 10 10 10 10 10 10 10 10 10 10 10 15 18 18 18 18 15 18 18 18 18 15 18 18 18 2 8 8 8 8 8 8 8 8 8 18 18 18 18 18 18 18 18 3 18 18 18 18 15 3 3 18 18 18 18 18 18 18 18 18 2 18 18 18 18 18 18 18 18 18 18 15 10 10 10 10 10 10 10 10 10 10 10 10 10 10 10 10 10 10 10 
10 10 10 10 10 10 10 10 10 10 10 10 10 10 10 10 10 10 10 10 15 18 18 8 8 15 18 18 18 18 15 18 18 18 18 18 18 18 18 18 18 18 18 18 18 18 18 18 2 18 18 18 3 18 18 18 18 15 3 3 18 18 18 18 18 18 3 18 18 2 18 18 18 18 18 3 3 18 18 18 15 10 10 10 10 10 10 10 10 10 10 10 10 10 10 10 10 10 10 10 
10 10 10 10 10 10 10 10 10 10 10 10 10 10 10 10 10 10 10 10 15 18 18 18 18 18 18 18 18 18 15 18 18 18 18 18 18 18 3 3 3 18 18 18 18 18 18 18 2 18 18 18 3 18 18 18 18 15 8 8 18 18 18 2 18 18 3 18 18 2 18 18 18 18 18 18 18 18 18 18 15 10 10 10 10 10 10 10 10 10 10 10 10 10 10 10 10 10 10 10 
10 10 10 10 10 10 10 10 10 10 10 10 10 10 10 10 10 10 10 10 15 18 18 18 18 18 18 18 18 18 15 18 18 18 18 18 18 18 18 18 18 18 18 18 18 18 18 18 2 18 18 18 3 18 18 18 18 18 18 18 18 18 18 2 18 18 18 18 18 2 18 18 18 8 8 8 8 8 8 8 15 10 10 10 10 10 10 10 10 10 10 10 10 10 10 10 10 10 10 10 
10 10 10 10 10 10 10 10 10 10 10 10 10 10 10 10 10 10 10 10 15 18 18 3 18 18 18 18 18 18 15 8 8 8 8 8 8 8 18 18 18 8 8 8 8 8 8 8 8 18 18 18 18 18 18 18 18 18 18 18 18 18 2 8 8 8 18 18 18 2 18 18 18 18 18 18 18 18 18 18 15 10 10 10 10 10 10 10 10 10 10 10 10 10 10 10 10 10 10 10 
10 10 10 10 10 10 10 10 10 10 10 10 10 10 10 10 10 10 10 10 15 18 18 3 18 18 18 18 18 18 18 18 18 18 18 18 18 18 18 18 18 18 18 18 18 18 18 18 18 18 18 18 18 18 18 18 18 18 18 18 18 18 2 18 18 18 18 18 18 2 18 18 18 18 18 18 18 18 18 18 15 10 10 10 10 10 10 10 10 10 10 10 10 10 10 10 10 10 10 10 
10 10 10 10 10 10 10 10 10 10 10 10 10 10 10 10 10 10 10 10 15 18 18 3 18 18 18 18 18 18 18 18 18 18 18 18 18 18 18 18 18 18 18 18 15 8 18 18 18 18 18 18 18 18 18 18 15 8 8 8 8 8 2 18 18 18 18 18 18 2 18 18 3 3 18 18 18 18 18 18 15 10 10 10 10 10 10 10 10 10 10 10 10 10 10 10 10 10 10 10 
10 10 10 10 10 10 10 10 10 10 10 10 10 10 10 10 10 10 10 10 15 18 18 3 18 18 2 18 18 18 18 18 18 18 18 18 18 18 2 18 18 18 18 18 15 18 18 18 18 18 8 8 8 8 8 8 15 18 18 18 18 18 2 18 18 3 3 18 18 2 18 18 3 3 18 18 8 8 8 8 15 10 10 10 10 10 10 10 10 10 10 10 10 10 10 10 10 10 10 10 
10 10 10 10 10 10 10 10 10 10 10 10 10 10 10 10 10 10 10 10 15 18 18 3 18 18 2 18 18 18 18 3 3 18 18 18 18 18 2 18 18 18 18 18 15 18 18 8 8 8 15 18 18 18 18 18 15 18 18 3 18 18 2 18 18 18 18 18 18 15 18 18 3 3 18 18 15 18 18 18 15 10 10 10 10 10 10 10 10 10 10 10 10 10 10 10 10 10 10 10 
10 10 10 10 10 10 10 10 10 10 10 10 10 10 10 10 10 10 10 10 15 18 18 3 18 18 2 18 18 18 18 3 3 18 18 18 18 18 2 8 8 8 18 18 15 18 18 18 18 18 15 18 18 3 18 18 15 18 18 18 18 18 2 18 18 18 18 18 18 18 18 18 18 18 18 18 2 18 18 18 15 10 10 10 10 10 10 10 10 10 10 10 10 10 10 10 10 10 10 10 
10 10 10 10 10 10 10 10 10 10 10 10 10 10 10 10 10 10 10 10 15 18 18 3 18 18 2 18 18 18 18 3 3 18 18 18 18 18 2 18 18 18 18 18 15 18 18 18 18 18 15 18 18 18 18 18 15 18 18 18 18 2 15 18 18 18 18 18 18 18 18 18 18 18 18 18 2 18 18 18 15 10 10 10 10 10 10 10 10 10 10 10 10 10 10 10 10 10 10 10 
10 10 10 10 10 10 10 10 10 10 10 10 10 10 10 10 10 10 10 10 15 18 18 3 18 18 2 18 18 18 18 3 3 18 18 18 18 18 2 18 18 18 18 18 15 8 8 8 18 18 15 18 18 18 18 18 15 18 18 18 18 2 18 18 18 18 8 8 8 8 8 8 8 18 18 18 2 18 3 18 15 10 10 10 10 10 10 10 10 10 10 10 10 10 10 10 10 10 10 10 
10 10 10 10 10 10 10 10 10 10 10 10 10 10 10 10 10 10 10 10 15 18 18 3 18 18 2 18 18 18 18 18 18 18 18 18 18 18 2 18 18 18 18 18 2 18 18 18 18 18 15 18 18 18 8 8 8 18 18 18 18 2 18 18 18 18 18 18 18 18 18 18 18 18 18 18 2 18 18 18 15 10 10 10 10 10 10 10 10 10 10 10 10 10 10 10 10 10 10 10 
10 10 10 10 10 10 10 10 10 10 10 10 10 10 10 10 10 10 10 10 15 18 18 18 18 18 2 18 18 18 18 18 18 18 18 18 18 18 2 18 18 8 8 8 2 18 18 18 8 8 15 18 18 18 18 18 18 18 18 18 18 2 18 18 18 18 18 18 18 18 18 18 18 18 18 18 15 18 18 18 15 10 10 10 10 10 10 10 10 10 10 10 10 10 10 10 10 10 10 10 
10 10 10 10 10 10 10 10 10 10 10 10 10 10 10 10 10 10 10 10 15 18 18 18 18 18 2 8 8 8 8 8 8 8 8 8 8 8 2 18 18 18 18 18 2 18 18 18 18 18 18 18 18 18 18 18 18 18 18 18 18 2 18 18 18 18 18 18 8 8 8 8 8 8 8 8 8 18 18 18 15 10 10 10 10 10 10 10 10 10 10 10 10 10 10 10 10 10 10 10 
10 10 10 10 10 10 10 10 10 10 10 10 10 10 10 10 10 10 10 10 15 18 18 18 18 18 18 18 18 18 18 18 18 18 18 18 18 18 2 18 18 18 18 18 2 18 18 18 18 18 18 18 18 3 3 3 3 18 18 18 18 2 18 18 18 18 18 18 18 18 18 18 18 18 18 18 18 18 18 18 15 10 10 10 10 10 10 10 10 10 10 10 10 10 10 10 10 10 10 10 
10 10 10 10 10 10 10 10 10 10 10 10 10 10 10 10 10 10 10 10 15 18 18 18 18 18 18 18 18 18 18 18 18 18 18 18 18 18 2 18 18 18 18 18 2 18 18 18 18 18 18 18 18 18 18 18 18 18 18 18 18 18 18 18 3 18 18 18 18 18 18 18 18 18 18 18 18 18 18 18 15 10 10 10 10 10 10 10 10 10 10 10 10 10 10 10 10 10 10 10 
10 10 10 10 10 10 10 10 10 10 10 10 10 10 10 10 10 10 10 10 15 18 18 3 18 18 18 18 3 18 18 18 8 8 18 18 18 8 2 8 8 8 8 8 2 18 18 18 18 8 8 8 8 8 8 8 8 8 18 18 18 18 18 18 3 18 18 18 18 18 18 18 3 18 18 18 18 18 18 18 15 10 10 10 10 10 10 10 10 10 10 10 10 10 10 10 10 10 10 10 
10 10 10 10 10 10 10 10 10 10 10 10 10 10 10 10 10 10 10 10 15 18 18 3 18 18 18 18 3 18 18 18 2 18 18 18 18 18 18 18 18 18 18 18 2 18 18 18 18 18 18 18 18 2 18 18 18 18 18 18 18 18 18 3 3 18 18 18 2 18 18 3 3 18 18 18 18 18 18 18 15 10 10 10 10 10 10 10 10 10 10 10 10 10 10 10 10 10 10 10 
10 10 10 10 10 10 10 10 10 10 10 10 10 10 10 10 10 10 10 10 15 18 18 3 3 3 3 3 3 18 18 18 2 18 18 3 18 18 3 18 18 18 18 18 2 3 3 18 18 18 18 18 18 2 18 18 18 18 18 18 18 18 18 18 18 18 18 18 2 18 18 3 18 18 18 18 2 8 8 8 15 10 10 10 10 10 10 10 10 10 10 10 10 10 10 10 10 10 10 10 
10 10 10 10 10 10 10 10 10 10 10 10 10 10 10 10 10 10 10 10 15 18 18 18 18 18 18 18 18 18 18 18 2 18 18 18 18 18 18 18 18 18 18 18 2 18 18 18 18 18 18 18 18 2 18 18 18 18 18 18 18 18 18 18 18 18 18 18 2 18 18 18 18 18 18 18 2 18 18 18 15 10 10 10 10 10 10 10 10 10 10 10 10 10 10 10 10 10 10 10 
10 10 10 10 10 10 10 10 10 10 10 10 10 10 10 10 10 10 10 10 15 18 18 18 8 8 8 8 8 8 8 8 8 8 8 8 8 18 18 18 8 8 8 8 15 18 18 18 2 18 18 18 18 18 18 3 18 18 18 18 8 8 8 8 8 8 8 8 2 18 18 18 2 18 18 18 2 18 18 18 15 10 10 10 10 10 10 10 10 10 10 10 10 10 10 10 10 10 10 10 
10 10 10 10 10 10 10 10 10 10 10 10 10 10 10 10 10 10 10 10 15 18 18 18 2 18 18 18 18 18 18 18 2 18 18 18 18 18 18 18 2 18 18 18 18 18 18 18 2 18 18 3 18 18 18 3 3 18 18 18 2 18 18 18 18 18 18 18 18 18 18 18 2 18 18 18 2 18 3 18 15 10 10 10 10 10 10 10 10 10 10 10 10 10 10 10 10 10 10 10 
10 10 10 10 10 10 10 10 10 10 10 10 10 10 10 10 10 10 10 10 15 18 18 18 2 18 18 18 18 18 18 18 2 18 18 18 18 18 18 18 2 18 18 18 18 18 18 18 2 18 18 3 18 18 18 3 3 18 18 18 2 18 18 18 18 18 18 18 18 18 18 18 2 18 18 18 2 18 18 18 15 10 10 10 10 10 10 10 10 10 10 10 10 10 10 10 10 10 10 10 
10 10 10 10 10 10 10 10 10 10 10 10 10 10 10 10 10 10 10 10 15 18 18 18 18 18 18 3 18 18 3 18 2 18 18 18 2 18 18 18 2 18 18 18 18 18 18 18 2 18 18 3 18 2 18 3 3 18 18 18 2 18 18 18 3 3 18 3 18 18 18 18 2 18 18 18 18 18 18 18 15 10 10 10 10 10 10 10 10 10 10 10 10 10 10 10 10 10 10 10 
10 10 10 10 10 10 10 10 10 10 10 10 10 10 10 10 10 10 10 10 15 18 18 18 18 18 18 3 3 3 3 18 2 18 18 18 2 18 18 18 18 18 18 18 2 18 18 18 2 18 18 18 18 2 18 18 18 18 18 18 2 18 18 18 3 3 3 3 18 18 18 18 2 18 18 18 18 18 18 18 15 10 10 10 10 10 10 10 10 10 10 10 10 10 10 10 10 10 10 10 
10 10 10 10 10 10 10 10 10 10 10 10 10 10 10 10 10 10 10 10 15 18 18 18 18 18 18 18 18 18 18 18 2 18 18 18 2 18 18 18 18 18 18 18 2 18 18 18 15 18 18 18 18 2 18 18 18 18 18 18 2 18 18 18 18 18 18 18 18 18 18 18 2 18 18 18 18 18 18 18 15 10 10 10 10 10 10 10 10 10 10 10 10 10 10 10 10 10 10 10 
10 10 10 10 10 10 10 10 10 10 10 10 10 10 10 10 10 10 10 10 7 8 8 8 8 8 8 8 8 8 8 8 8 8 8 8 8 8 8 8 8 8 8 8 8 8 8 8 8 8 8 8 8 8 8 8 8 8 8 8 8 8 8 8 8 8 8 8 8 8 8 8 8 8 8 8 8 8 8 8 9 10 10 10 10 10 10 10 10 10 10 10 10 10 10 10 10 10 10 10 
10 10 10 10 10 10 10 10 10 10 10 10 10 10 10 10 10 10 10 10 10 10 10 10 10 10 10 10 10 10 10 10 10 10 10 10 10 10 10 10 10 10 10 10 10 10 10 10 10 10 10 10 10 10 10 10 10 10 10 10 10 10 10 10 10 10 10 10 10 10 10 10 10 10 10 10 10 10 10 10 10 10 10 10 10 10 10 10 10 10 10 10 10 10 10 10 10 10 10 10 
10 10 10 10 10 10 10 10 10 10 10 10 10 10 10 10 10 10 10 10 10 10 10 10 10 10 10 10 10 10 10 10 10 10 10 10 10 10 10 10 10 10 10 10 10 10 10 10 10 10 10 10 10 10 10 10 10 10 10 10 10 10 10 10 10 10 10 10 10 10 10 10 10 10 10 10 10 10 10 10 10 10 10 10 10 10 10 10 10 10 10 10 10 10 10 10 10 10 10 10 
10 10 10 10 10 10 10 10 10 10 10 10 10 10 10 10 10 10 10 10 10 10 10 10 10 10 10 10 10 10 10 10 10 10 10 10 10 10 10 10 10 10 10 10 10 10 10 10 10 10 10 10 10 10 10 10 10 10 10 10 10 10 10 10 10 10 10 10 10 10 10 10 10 10 10 10 10 10 10 10 10 10 10 10 10 10 10 10 10 10 10 10 10 10 10 10 10 10 10 10 
10 10 10 10 10 10 10 10 10 10 10 10 10 10 10 10 10 10 10 10 10 10 10 10 10 10 10 10 10 10 10 10 10 10 10 10 10 10 10 10 10 10 10 10 10 10 10 10 10 10 10 10 10 10 10 10 10 10 10 10 10 10 10 10 10 10 10 10 10 10 10 10 10 10 10 10 10 10 10 10 10 10 10 10 10 10 10 10 10 10 10 10 10 10 10 10 10 10 10 10 
10 10 10 10 10 10 10 10 10 10 10 10 10 10 10 10 10 10 10 10 10 10 10 10 10 10 10 10 10 10 10 10 10 10 10 10 10 10 10 10 10 10 10 10 10 10 10 10 10 10 10 10 10 10 10 10 10 10 10 10 10 10 10 10 10 10 10 10 10 10 10 10 10 10 10 10 10 10 10 10 10 10 10 10 10 10 10 10 10 10 10 10 10 10 10 10 10 10 10 10 
10 10 10 10 10 10 10 10 10 10 10 10 10 10 10 10 10 10 10 10 10 10 10 10 10 10 10 10 10 10 10 10 10 10 10 10 10 10 10 10 10 10 10 10 10 10 10 10 10 10 10 10 10 10 10 10 10 10 10 10 10 10 10 10 10 10 10 10 10 10 10 10 10 10 10 10 10 10 10 10 10 10 10 10 10 10 10 10 10 10 10 10 10 10 10 10 10 10 10 10 
10 10 10 10 10 10 10 10 10 10 10 10 10 10 10 10 10 10 10 10 10 10 10 10 10 10 10 10 10 10 10 10 10 10 10 10 10 10 10 10 10 10 10 10 10 10 10 10 10 10 10 10 10 10 10 10 10 10 10 10 10 10 10 10 10 10 10 10 10 10 10 10 10 10 10 10 10 10 10 10 10 10 10 10 10 10 10 10 10 10 10 10 10 10 10 10 10 10 10 10 
10 10 10 10 10 10 10 10 10 10 10 10 10 10 10 10 10 10 10 10 10 10 10 10 10 10 10 10 10 10 10 10 10 10 10 10 10 10 10 10 10 10 10 10 10 10 10 10 10 10 10 10 10 10 10 10 10 10 10 10 10 10 10 10 10 10 10 10 10 10 10 10 10 10 10 10 10 10 10 10 10 10 10 10 10 10 10 10 10 10 10 10 10 10 10 10 10 10 10 10 
10 10 10 10 10 10 10 10 10 10 10 10 10 10 10 10 10 10 10 10 10 10 10 10 10 10 10 10 10 10 10 10 10 10 10 10 10 10 10 10 10 10 10 10 10 10 10 10 10 10 10 10 10 10 10 10 10 10 10 10 10 10 10 10 10 10 10 10 10 10 10 10 10 10 10 10 10 10 10 10 10 10 10 10 10 10 10 10 10 10 10 10 10 10 10 10 10 10 10 10 
10 10 10 10 10 10 10 10 10 10 10 10 10 10 10 10 10 10 10 10 10 10 10 10 10 10 10 10 10 10 10 10 10 10 10 10 10 10 10 10 10 10 10 10 10 10 10 10 10 10 10 10 10 10 10 10 10 10 10 10 10 10 10 10 10 10 10 10 10 10 10 10 10 10 10 10 10 10 10 10 10 10 10 10 10 10 10 10 10 10 10 10 10 10 10 10 10 10 10 10 
10 10 10 10 10 10 10 10 10 10 10 10 10 10 10 10 10 10 10 10 10 10 10 10 10 10 10 10 10 10 10 10 10 10 10 10 10 10 10 10 10 10 10 10 10 10 10 10 10 10 10 10 10 10 10 10 10 10 10 10 10 10 10 10 10 10 10 10 10 10 10 10 10 10 10 10 10 10 10 10 10 10 10 10 10 10 10 10 10 10 10 10 10 10 10 10 10 10 10 10 
10 10 10 10 10 10 10 10 10 10 10 10 10 10 10 10 10 10 10 10 10 10 10 10 10 10 10 10 10 10 10 10 10 10 10 10 10 10 10 10 10 10 10 10 10 10 10 10 10 10 10 10 10 10 10 10 10 10 10 10 10 10 10 10 10 10 10 10 10 10 10 10 10 10 10 10 10 10 10 10 10 10 10 10 10 10 10 10 10 10 10 10 10 10 10 10 10 10 10 10 
10 10 10 10 10 10 10 10 10 10 10 10 10 10 10 10 10 10 10 10 10 10 10 10 10 10 10 10 10 10 10 10 10 10 10 10 10 10 10 10 10 10 10 10 10 10 10 10 10 10 10 10 10 10 10 10 10 10 10 10 10 10 10 10 10 10 10 10 10 10 10 10 10 10 10 10 10 10 10 10 10 10 10 10 10 10 10 10 10 10 10 10 10 10 10 10 10 10 10 10 
10 10 10 10 10 10 10 10 10 10 10 10 10 10 10 10 10 10 10 10 10 10 10 10 10 10 10 10 10 10 10 10 10 10 10 10 10 10 10 10 10 10 10 10 10 10 10 10 10 10 10 10 10 10 10 10 10 10 10 10 10 10 10 10 10 10 10 10 10 10 10 10 10 10 10 10 10 10 10 10 10 10 10 10 10 10 10 10 10 10 10 10 10 10 10 10 10 10 10 10 
10 10 10 10 10 10 10 10 10 10 10 10 10 10 10 10 10 10 10 10 10 10 10 10 10 10 10 10 10 10 10 10 10 10 10 10 10 10 10 10 10 10 10 10 10 10 10 10 10 10 10 10 10 10 10 10 10 10 10 10 10 10 10 10 10 10 10 10 10 10 10 10 10 10 10 10 10 10 10 10 10 10 10 10 10 10 10 10 10 10 10 10 10 10 10 10 10 10 10 10 
10 10 10 10 10 10 10 10 10 10 10 10 10 10 10 10 10 10 10 10 10 10 10 10 10 10 10 10 10 10 10 10 10 10 10 10 10 10 10 10 10 10 10 10 10 10 10 10 10 10 10 10 10 10 10 10 10 10 10 10 10 10 10 10 10 10 10 10 10 10 10 10 10 10 10 10 10 10 10 10 10 10 10 10 10 10 10 10 10 10 10 10 10 10 10 10 10 10 10 10
10 10 10 10 10 10 10 10 10 10 10 10 10 10 10 10 10 10 10 10 10 10 10 10 10 10 10 10 10 10 10 10 10 10 10 10 10 10 10 10 10 10 10 10 10 10 10 10 10 10 10 10 10 10 10 10 10 10 10 10 10 10 10 10 10 10 10 10 10 10 10 10 10 10 10 10 10 10 10 10 10 10 10 10 10 10 10 10 10 10 10 10 10 10 10 10 10 10 10 10 
10 10 10 10 10 10 10 10 10 10 10 10 10 10 10 10 10 10 10 10 10 10 10 10 10 10 10 10 10 10 10 10 10 10 10 10 10 10 10 10 10 10 10 10 10 10 10 10 10 10 10 10 10 10 10 10 10 10 10 10 10 10 10 10 10 10 10 10 10 10 10 10 10 10 10 10 10 10 10 10 10 10 10 10 10 10 10 10 10 10 10 10 10 10 10 10 10 10 10 10 
10 10 10 10 10 10 10 10 10 10 10 10 10 10 10 10 10 10 10 10 10 10 10 10 10 10 10 10 10 10 10 10 10 10 10 10 10 10 10 10 10 10 10 10 10 10 10 10 10 10 10 10 10 10 10 10 10 10 10 10 10 10 10 10 10 10 10 10 10 10 10 10 10 10 10 10 10 10 10 10 10 10 10 10 10 10 10 10 10 10 10 10 10 10 10 10 10 10 10 10
